############################
#************##************#
#*####*#####*##*####*#####*#
#@####*#####*##*####*#####@#
#*####*#####*##*####*#####*#
#**************************#
#*####*##*########*##*####*#
#*####*##*########*##*####*#
#******##****##****##******#
######*##### ## #####*######
     #*##### ## #####*#    
     #*##          ##*#     
     #*## ###==### ##*#     
######*## ###==### ##*######
      *   ##    ##   *      
######*## ######## ##*######
     #*## ######## ##*#     
     #*##          ##*#     
     #*## ######## ##*#     
######*## ######## ##*######
#************##************#
#*####*#####*##*#####*####*#
#*####*#####*##*#####*####*#
#@**##*******  *******##**@#
###*##*##*########*##*##*###
###*##*##*########*##*##*###
#******##****##****##******#
#*##########*##*##########*#
#*##########*##*##########*#
#**************************#
############################